############################################################
############################################################
## P                                                    I ##
##                                                        ##
##                                                        ##
##                                                        ##
##                                                        ##
##                                                        ##
##                                                        ##
##                                                        ##
##                                                        ##
##                                                        ##
##                                                        ##
##                                                        ##
##                                                        ##
##                                                        ##
##                                                        ##
##                                                        ##
##                                                        ##
##                                                        ##
##                                                        ##
##                                          I             ##
##                                                        ##
##                                                        ##
##                                                        ##
##                                                        ##
##                                                        ##
##                                                        ##
############################################################
############################################################