############################################################
############################################################
## P                                                      ##
##                                                        ##
##                                                        ##
##         #######                                        ##
##         #                                              ##
##         #           I                                  ##
##         #                            ####################
##         #                            #                 ##
############                            #                 ##
##                                      #                 ##
##                                      #                 ##
##                                      #                 ##
##                                      #                 ##
##                                      ######            ##
##         ######                       #                 ##
##         #                            #                 ##
##         #                            #                 ##
##         #  I                         #                 ##
##         #                            #                 ##
##         #                            #   I             ##
##     #####                    #########                 ##
##     #                        #                         ##
########                   ######                         ##
##                                                        ##
##                                                        ##
##                                                        ##
############################################################
############################################################