############################################################
############################################################
##                                                        ##
##                                                        ##
##                                                        ##
##                                                        ##
##                                                        ##
##                                                        ##
##                                                        ##
##                                                        ##
##            P                                           ##
##                                                        ##
##                                                        ##
##                                                        ##
##                                                        ##
##                                                        ##
##                                                        ##
##                                                        ##
##                                                        ##
##                                                        ##
##                                                        ##
##                                          I             ##
##                                                        ##
##                                                        ##
##                                                        ##
##                                                        ##
##                                                        ##
##                                                        ##
############################################################
############################################################